111111
100111
10E011
1001E1
1P1111
111111