11111
1P001
10001
100E1
1C111
11111