1111111111
1P0000E1C1
1001000001
1111111111